1,2,2,2,2,2,2,2,2,2,2,2,2,2,2,2,2,2,2,2,2,2,2,2,2,2,2,2,2,3,
9,10,10,10,10,10,10,10,10,10,10,10,10,10,10,10,10,10,10,10,10,10,10,10,10,10,10,10,10,11,
6,6,6,6,6,6,6,6,6,6,6,6,6,6,6,6,6,6,6,6,6,6,6,6,6,6,6,6,6,6,
6,6,6,6,6,6,6,6,6,6,6,6,6,6,6,6,6,6,6,6,6,6,6,6,6,6,6,6,6,6,
6,6,6,6,6,6,6,6,6,6,6,6,6,6,6,6,6,6,6,6,6,6,6,6,6,6,6,6,6,6,
6,6,6,6,6,6,6,6,6,6,6,15,10,10,10,10,10,10,10,16,6,6,6,6,6,6,6,6,6,6,
15,10,10,10,10,10,10,16,6,6,6,7,4,4,4,4,4,4,4,5,6,6,6,15,10,10,10,10,10,16,
19,2,2,2,2,2,2,20,6,6,6,19,2,2,2,2,2,2,2,20,6,6,6,19,2,2,2,2,2,20,
1,6,6,6,6,6,6,6,6,6,6,6,6,6,6,6,6,6,6,6,6,6,6,6,6,6,6,6,6,3,
5,6,6,6,6,6,6,6,6,6,6,6,6,6,6,6,6,6,6,6,6,6,6,6,6,6,6,6,6,7,
5,6,6,6,6,6,6,6,6,6,6,6,6,6,6,6,6,6,6,6,6,6,6,6,6,6,6,6,6,7,
5,6,6,6,6,6,6,6,6,6,6,6,6,6,6,6,6,6,6,6,6,6,6,6,6,6,6,6,6,7,
5,6,6,6,15,10,10,10,10,10,10,10,10,10,10,10,10,10,10,10,10,10,10,10,10,16,6,6,6,7,
5,6,6,6,19,2,2,2,2,2,2,2,2,2,2,2,2,2,2,2,2,2,2,2,2,20,6,6,6,7,
5,6,6,6,6,6,6,6,6,6,6,6,6,6,6,6,6,6,6,6,6,6,6,6,6,6,6,6,6,7,
5,6,6,6,6,6,6,6,6,6,6,6,6,6,6,6,6,6,6,6,6,6,6,6,6,6,6,6,6,7,
5,6,6,6,6,6,6,6,6,6,6,6,6,6,6,6,6,6,6,6,6,6,6,6,6,6,6,6,6,7,
9,10,10,10,10,10,10,10,10,10,10,10,16,0,0,4,0,15,10,10,10,10,10,10,10,10,10,10,10,11,
6,6,6,6,6,6,6,6,6,6,6,6,5,4,4,4,4,7,6,6,6,6,6,6,6,6,6,6,6,6,
6,6,6,6,6,6,6,6,6,6,6,6,5,6,6,6,6,7,6,6,6,6,6,6,6,6,6,6,6,6